NO textures/téléchargement.xpm
SO textures/grapefruit.xpm
WE textures/images.xpm
EA textures/images.xpm

C 225,30,250
F 255,0,0


11111111111111111      1111111111111
1000000000011          1000000000001
100000000001           1000000000001
100000000001           1000000000001
100000000001111111111111000000000001
1000000000000000000000000000E0000001
100000000001111111111111000000000011
100000000001           1000000000001
100000000001           1000000000001
100000000001           1000000000001
100000000001           1000000000001
100001000111           1000000000001
100011100001           1000000000001
111111111111           1111111111111





