

SO textures/grapefruit.xpm


C 225,30,250


NO textures/téléchargement.xpm

WE textures/images.xpm
EA textures/images.xpm


F 255,255,0



                                                           1111
                                                           1001
                                                           1001
                                                           1001
                                                           1001
                                                           1001
11111111111111111      11111111111111111111111111111111111110011111111111111111111111111
1000000000011          10000000000000000000000000000000000000000000000000000000000000001
100000000001           10000000000000000000000000011100000001110000000000000000000000001
100000000001           10000000000011000000000000000000000001110000000000010000000000001
10000000000111111111111100000000000000000000000000000000000000000000000000000000001000W1
1000000000000000000000000000000000000000000000111111111111111111111111111111111111111111
10000000000111111111111100000000001000000000011
100000000001           100000000000000000000001
100000000001           100000000000000000000001
100000000001           100000000000000000000001
100000000001           100000000000111000000001
100001000111           100000000000000000000001
100011100001           100000000000000000000001
111111111111           111111111111111111111111





