11111111        11111111111
10000001        10000000001
10000001        1000000000111111
11111111111111111111111111111111

11111111111111111111111111111111
11111101111111111000000000000001
     100000000000000000000000001
     111111111111111111111111111